|========|
|==######|
|==#    #|
|###OOO #|
|#@ OXX #|
|# OXXX##|
|####  #=|
|===####=|
||=======|
