|========|
|==#####=|
|###  @#=|
|#  OX ##|
|#  XOX #|
|### QO #|
|==#   ##|
|==######|
||=======|
