|==========|
|==########|
|==#   #X #|
|=##  OXXX#|
|=#  O #QX#|
|## ##O# ##|
|#   O  O #|
|#   #    #|
|#######@ #|
|======####|
||=========|
