|=========|
|########=|
|#      #=|
|# #OO  #=|
|# XXX# #=|
|##XXXO ##|
|=# ## O #|
|=#O  O  #|
|=#  #  @#|
|=########|
||========|
